{
    "1": 2,
    "2": 1,
    "3": 4,
    "4": 3,
    "5": 6,
    "6": 5,
    "7": 8,
    "8": 7,
    "9": 10,
    "10": 9,
    "11": 12,
    "12": 11,
    "13": 14,
    "14": 13,
    "15": 16,
    "16": 15,
    "17": 18,
    "18": 17,
    "19": 19,
    "20": 21,
    "21": 20,
    "22": 23,
    "23": 22,
    "24": 25,
    "25": 24,
    "26": 27,
    "27": 26,
    "28": 29,
    "29": 28,
    "30": 31,
    "31": 30,
    "32": 33,
    "33": 32,
    "34": 35,
    "35": 34,
    "36": 37,
    "37": 36,
    "38": 39,
    "39": 38,
    "40": 41,
    "41": 40,
    "42": 43,
    "43": 42,
    "44": 44,
    "45": 46,
    "46": 45,
    "47": 48,
    "48": 47,
    "49": 49,
    "50": 51,
    "51": 50,
    "52": 53,
    "53": 52,
    "54": 55,
    "55": 54,
    "56": 57,
    "57": 56,
    "58": 59,
    "59": 58,
    "60": 61,
    "61": 60,
    "62": 63,
    "63": 62,
    "64": 65,
    "65": 64,
    "66": 67,
    "67": 66,
    "68": 69,
    "69": 68,
    "70": 71,
    "71": 70,
    "72": 73,
    "73": 72,
    "74": 75,
    "75": 74,
    "76": 77,
    "77": 76,
    "78": 79,
    "79": 78,
    "80": 81,
    "81": 80,
    "82": 83,
    "83": 82,
    "84": 85,
    "85": 84,
    "86": 87,
    "87": 86,
    "88": 89,
    "89": 88,
    "90": 91,
    "91": 90,
    "92": 93,
    "93": 92,
    "94": 95,
    "95": 94
}